LE PALAYS
CLASSE	1	MONTAUDRAN
A61	LASBORDES
A20	SOUPETARD
A62	LA ROSERAIE
A65	LA CROIX DAURADE
A64	BORDEROUGE
A62	LES IZARDS
Le	TOULOUSE NORD/EST
Palays	SESQUIERES
Montaudran	TOULOUSE NORD/OUEST
Lasbordes	SAINT-JORY
Soupetard	SAINT-JORY EUROCENTRE
La	MONTAUBAN NORD
Roseraie	A20 61 ZI NORD
La	CHAUMES
Croix	Daurade	BEAUSOLEIL
Borderouge	SAPIAC
Les	LA MOLLE
Izards	PARAGES
Sesquières	MOULIS
Montauban	nord	MONTAUBAN SUD
ZI	CASTELSARRASIN
nord	VALENCE-D'AGEN
Chaumes	AGEN
Beausoleil	AGEN OUEST
Sapiac	AIGUILLON
La	MAMANDE
Molle	LA REOLE
Parages	LANGON
La	PODENSAC
Brède	PEAGE DE SAINT-SELVE
Moulis	LA BREDE
Briscous	BAZAS
Urt	CAPTIEUX
Saint0	Martory	ROQUEFORT
Boussens	LE CALOY
Martres0	Tolosane	AIRE SUR ADOUR NORD
Péage	de	Toulouse	AIRE SUR ADOUR SUD
nord/	GARLIN
est	THEZE
Péage	de	Toulouse	MOUSSEROLLES
nord/	MOUGUERRE BOURG
ouest	MOUGUERRE ELIZABERRY
Péage	de	Saint0	Selve	BISCROUS
Péage	de	Sames	URT
Péage	de	Lestelle	GUICHE
Saint0	Jory	PEAGE DE SAMES
Eurocentre	PEYREHORADE
Montauban	SALIES
Castelsarrasin	ORTHEZ
Valence0	d’Agen	ARTIX
Agen	LESCAR
AiguillonAgen	Ouest	PAU CENTRE
Marmande	SOUMOULOU
La	TARBES OUEST
Réole	TARBES EST
Langon	TOURNAY
Podensac	CAPVERN
Bazas	LANNEMEZAN
Captieux	MONTREJEAU
Roquefort	SAINT-GAUDENS
Le	PEAGE DE LESTELLE
Caloy	LESTELLE DE SAINT MARTORY
Aire0	sur0	Adour	SAINT MARTORY
nord	BOUSSENS
Aire0	sur0	Adour	MARTRES TOLOSANE