LE PALAYS
CLASSE	5	MONTAUDRAN
A61A20A62	A65A64	LASBORDES
A61	SOUPETARD
A20	LA ROSERAIE
A62	LA CROIX DAURADE
A65	BORDEROUGE
A64	LES IZARDS
A62	TOULOUSE NORD/EST
Le	SESQUIERES
Palays	TOULOUSE NORD/OUEST
Montaudran	SAINT-JORY
Lasbordes	SAINT-JORY EUROCENTRE
Soupetard	MONTAUBAN NORD
La	A20 61 ZI NORD
Roseraie	CHAUMES
La	BEAUSOLEIL
Croix	Daurade	SAPIAC
Borderouge	LA MOLLE
Les	PARAGES
Izards	MOULIS
Sesquières	MONTAUBAN SUD
Montauban	nord	CASTELSARRASIN
ZI	VALENCE-D'AGEN
nord	AGEN
Chaumes	AGEN OUEST
Beausoleil	AIGUILLON
Sapiac	MAMANDE
La	LA REOLE
Molle	LANGON
Parages	PODENSAC
La	PEAGE DE SAINT-SELVE
Brède	LA BREDE
Moulis	BAZAS
Briscous	CAPTIEUX
Urt	ROQUEFORT
Saint0	Martory	LE CALOY
Boussens	AIRE SUR ADOUR NORD
Martres0	Tolosane	AIRE SUR ADOUR SUD
Péage	de	Toulouse	GARLIN
nord/	THEZE
est	MOUSSEROLLES
Péage	de	Toulouse	MOUGUERRE BOURG
nord/	MOUGUERRE ELIZABERRY
ouest	BISCROUS
Péage	de	Saint0	Selve	URT
Péage	de	Sames	GUICHE
Péage	de	Lestelle	PEAGE DE SAMES
Saint0	Jory	PEYREHORADE
Eurocentre	SALIES
Montauban	ORTHEZ
Castelsarrasin	ARTIX
Valence0	d’Agen	LESCAR
Agen	PAU CENTRE
AiguillonAgen	Ouest	SOUMOULOU
Marmande	TARBES OUEST
La	TARBES EST
Réole	TOURNAY
Langon	CAPVERN
Podensac	LANNEMEZAN
Bazas	MONTREJEAU
Captieux	SAINT-GAUDENS
Roquefort	PEAGE DE LESTELLE
Le	LESTELLE DE SAINT MARTORY
Caloy	SAINT MARTORY
Aire0	sur0	Adour	BOUSSENS
nord	MARTRES TOLOSANE